SXXXXXXX______
X__X___R______
XXXXX________
___X_XXXX_____
RXXXR___XXXXX_
___X______X_X_
__RXR_____X_X_
___G______XXX_
______________
GXXXXXXXX__XXX
______R_X__X__
________X__X__
____XXXXXXXXR_
______X____X__