SXXX______
X__X______
XR_X______
___X______
RXXXR_____
___X______
__RXR_____
___G______
__________
GXXXXXXXX_
______R_X_
________X_
____XXXXX_
______X___